########################################
......................................##
......................................##
......................................##
......................................##
......................................#
......................................#
......................................#
.............################.........#
.......................................#
.......................................#
.......................................#
.......###########################.....#
.......................................
......############################.....
.......................................
.......................................
.......................................
.......................................
.......................................
.......................................
.......................................
.......................................
.......................................
.......................................
......................................#
......................................#
......................................#
......................................#
..........#############################
.......................................
.......................................
.......................................
.......................................
.......................................
.......................................
.......................................
.......................................
.......................................
.......................................