########################################
#......................................#
#......................................#
#......................................#
#......................................#
#.........#######################......#
#.........#.....................#......#
#.........#.....................#......#
#.........#.....................#......#
#.........#.........#...........#......#
#.........#.........####........#.......
..........#.........#...........#.......
..........#.........#...........#.......
..........#.....................#.......
..........#.....................#.......
..........#.....................#.......
........................................
........................................
........................................
........................................
........................................
........................................
........................................
........................................
........................................
........................................
........................................
........................................
........................................
........................................
........................................
........................................
........................................
........................................
........................................
........................................
........................................
........................................
........................................
........................................